0000000000000000
0000000000000000
0000#|##[7[#000000
0000000G00000000
0000000000000000
00###]6]######0000
0000000000000000
0000000000000000
0##]7]#######[6[###0
0000000000000000
0000000000000000
####g###########
